Num. Frames : All
Ref. File   : given-tests/level1.txt
-------------------------------
Reference String:
 4:R,  1:W,  3:R,  2:W,  4:R
-------------------------------
####################################################
#     Frames    Opt.    FIFO     LRU      SC     ESC
#          1       5       5       5       5       5
#          2       4       5       5       5       5
#          3       4       5       5       5       5
#          4       4       4       4       4       4
#          5       4       4       4       4       4
#          6       4       4       4       4       4
#          7       4       4       4       4       4
####################################################
